#########
# ...   #
# $     #
#  $    #
#   $   #
#     @ #
#       #
#########
